1111111111111111111111111111111111
1CCCCCCCCCCCCCCCPE0000000000000001
1111111011110111111111111111111111
1000000010000000100000010001000001
1010010000001010001001001000101001
1000000001000000000000000000000001
1111111111111111111111111111111111