1111111111111111111111111111111111
1CCCCCCCCCCCCCCC0E0000000000000001
1111111011110111111111111111111111
1000000010000000100000010001000001
10100100000010100010P1001000101001
1000000001000000000000000000000001
1111111111111111111111111111111111