1111111111111111111111111111111111
1P00C000000000000000000C000C000001
1C11111111111111111111111111111111
1000000010000C00100000010001000001
1010010000001010001001C00100010101
100000000100000C00000000000C0000E1
1111111111111111111111111111111111