1111111111111
1000000000C01
1001001111101
1P011100C00E1
1111111111111