111111111111111111111111111111111111
1000C000000001P1111000000000C10000C1
1101100001000C01110000000001000011C1
1C10C0100100000C00010000C00100001101
1C00000000001000111101000C111110C1C1
1000010000001000000C00010000000000E1
111111111111111111111111111111111111