1111111111111
1000010000C01
1001000111001
1P011100000E1
1111111111111