1111111111111111
1000C000000000P1
1C11111111111111
1000000000000001
1010010000010101
10000000000000E1
1111111111111111