1111111111111111111111111111111111
1P00C000000011100000000C000C000001
1C10010010001C1000100100C0000101C1
100000000100000C00000000000C0000E1
1111111111111111111111111111111111