1111111111111111111111111111111111
1C0CCCCCCCCCCCCC0E0000000000000001
1111111011110111111111111111111111
1000000P10000000100000010001000001
1010010000001010001001001000101001
1000000001000000111101111000000001
1111111111111111111111111111111111