1111111111111111111111111111111111
101000000010000C01000C000000000001
1010010100100000011001000000010101
1E10010010111111001001000000010101
1P0000000C00C0000000000000000000C1
1111111111111111111111111111111111