1111111
1P00011
10E0101
100C001
100C001
1111111