11111111111111111
1P0001000C10000C1
1100000C000001011
100000000000001E1
10001C00000000001
11111111111111111