111111111111111111
100001100000001101
1000100P0101111101
1000000E0000001101
10000000000000C101
111111111111111111