1111111111111111111111111111111111
101000100010000C01000C000000100P01
1010010100100000011001010000010101
1E10000010111111001001110000010101
100001000C00C0000000000000000000C1
1111111111111111111111111111111111