111111111111111111111111111111111111
1100C00100C100C0C01C00C000C00100P011
110100101001C0000C110010100000101011
10E10C00010111111001C011100000101011
10C0001000C00C0100000C0000C000000C11
100C00001C0000000C1000000C0000001C11
111111111111111111111111111111111111