1111111111111111111111111
1E1010000100100001C1011C1
10010000000000C1CCC000001
100C10000011C000P00100101
1001000100000010001000C01
11010CC0010CC0C0100100001
110100000101010C001C00001
100C01000C000000C010C0001
100100CC10000111010110101
11C0C0C0010000C001110C111
10C00001000000C1C0CC01001
1CC0C01C0CC00C10001010101
1001C100000010000CC001001
1111111111111111111111111