11111111111111111111111111
1E110100C1CC1100C010C1C011
10010C0001C0C01100010CC111
10CC1C1C011010C010100C0011
10100111C1111CCC00100CCC11
101C0011001C0001C000000C11
11011C0C10111C1010101100C1
10C00C010C000CC11110C1C1C1
1C1001000C00010C0001C11C01
1001000100000010001000C011
11010CC0010CC0C01001000001
110100000101010C001C000011
100C01000C000000C010C000C1
100100CC100001110101101011
11C0C0C0010000C001110C1111
10C00001000000C1C0CC010011
1CC0C01C0CC00C100010101011
1001C100000010000CC000P0C1
11111111111111111111111111